111111111111111111111111
1P00000110000C10000000E1
100110011001111000100001
100110000000000000100001 
100110001111100001111001
1000000000C1100000000001
111111111111111111111111